################
#00000000000000#
#00000000000000#
#00000##########
#00F00000000000#
#0000B00#000000#
#0000000#000000#
#0000000#000000#
#00000000000000#
########B000000#
#00000000000000#
#0000000B000000#
#00000000000000#
#00000000000000#
################

0000000000000000
0000000000000000
0000000000000000
0000000000000000
0000000000000000
0000000000000000
0000000000000000
0000000000000000
0000000000000000
0000000000000000
0000000000000000
000000000000B000
000000000000B000
0000000000000000
0000000000000000

################
#00000000000000#
#0B0B0B0B0B0B00#
#0B0B0B0B0B0B00#
#000000000B0000#
#0B0B0B0B0B0B00#
#0B0B0B0B0B0B00#
#00000000000000#
#00000000F00000#
#0000000B000000#
#00000000000000#
#0000000B000000#
#00000000000000#
#00000000000000#
################

0000000000000000
0000000000000000
0000000000000000
0000000000000000
0000000000000000
0000000000000000
0000000000000000
0000000000000000
0000000000000000
0000000000000000
0000000000000000
000000000000B000
000000000000B000
0000000000000000
0000000000000000

################
#00000000000000#
#0000BBBBB00000#
#00000000B00000#
#00000000B00000#
#0000BBBBB00000#
#0000B000000000#
#0000B000000000#
#0000BBBBB00000#
#00000000000000#
#00000000000000#
#00000000000000#
#0000000F000000#
#00000000000000#
################

0000000000000000
0000000000000000
0000000000000000
0000000000000000
0000000000000000
0000000000000000
0000000000000000
0000000000000000
0000000000000000
0000000000000000
0000000000000000
000000000000B000
000000000000B000
0000000000000000
0000000000000000