################
#00000000000000#
#00000000000000#
#00000##########
#00000000000000#
#0000B000000000#
#00000000000000#
#00000000000000#
#00000000000000#
#0000000B000000#
#00000000000000#
#0000000B000000#
#00000000000000#
#00000000000000#
################

0000000000000000
0000000000000000
0000000000000000
0000000000000000
0000000000000000
00000000F0000000
0000000000000000
0000000000000000
0000000000000000
0000000000000000
0000000000000000
000000000000B000
000000000000B000
0000000000000000
0000000000000000

################
#00000000000000#
#00000000000000#
#00000BBBBBBBBB#
#000000000B0000#
#0000B0000B0000#
#000000000B0000#
#00000000000000#
#00000000000000#
#0000000B000000#
#00000000000000#
#0000000B000000#
#00000000000000#
#00000000000000#
################

0000000000000000
0000000000000000
0000000000000000
0000000000000000
0000000000000000
00000000F0000000
0000000000000000
0000000000000000
0000000000000000
0000000000000000
0000000000000000
000000000000B000
000000000000B000
0000000000000000
0000000000000000