0000000000000000
0              0
0              0
0       ###    0
0       #B#    0
0       # #    0
0       # #    0
0       # #    0
0 ####### #    0
0 #F  C   #    0
0 ######  #    0
0      ####    0
0              0
0              0
0000000000000000

0000000000000000
0              0
0              0
0   #########  0
0   # BC   B#  0
0   #       #  0
0   ##C###C##  0
0   #B      #  0
0  ######## #  0
0  #F  CB   #  0
0  ###   ####  0
0    #####     0
0              0
0              0
0000000000000000

0000000000000000
0              0
0  #####       0
0  #F  #       0
0  # C #       0
0  # CC#       0
0  ### #####   0
0   #   BBB#   0
0   #  #####   0
0   #  #       0
0   ####       0
0              0
0              0
0              0
0000000000000000

0000000000000000
0              0
0     ####     0
0   ###  ###   0
0   #  C   #   0
0   #  C  F#   0
0   ## C ###   0
0    # C #     0
0    # B #     0
0    # B #     0
0    # B #     0
0    # B #     0
0    #####     0
0              0
0000000000000000

0000000000000000
0              0
0              0
0     #####    0
0   ###   #    0
0   #BFC  #    0
0   # # CB#    0
0   #B##C #    0
0   # # B ##   0
0   #  CCCB#   0
0   #   B  #   0
0   ########   0
0              0
0              0
0000000000000000

0000000000000000
0              0
0              0
0              0
0    ######    0
0    #    ##   0
0   ##B##C #   0
0   # BBC  #   0
0   #  #C  #   0
0   #F   ###   0
0   ######     0
0              0
0              0
0              0
0000000000000000

0000000000000000
0              0
0  ###         0
0###F########  0
0#BB  #     ###0
0#BB  # C  C  #0
0#BB  #C####  #0
0#BB      ##  #0
0#BB  # #  C ##0
0###### ##C C #0
0  # C  C C C #0
0  #    #     #0
0  ############0
0              0
0000000000000000

0000000000000000
0              0
0              0
0   ######     0
0   #    #     0
0   #    ###   0
0   # ## C #   0
0   #  #   #   0
0   # C CC #   0
0   ##C## ##   0
0   #F #   #   0
0   ## B C #   0
0    #######   0
0              0
0000000000000000