################
#00000000000000#
#00000000000000#
#00000##########
#00F00000000000#
#0000C00#000000#
#0000000#000000#
#0000000#000000#
#00000000000000#
########C0000B0#
#00000000000000#
#0000000C000000#
#00000000000B00#
#00000000000000#
################

################
#00000000000000#
#0C0C0C0C0C0C00#
#0C0C0C0C0C0C00#
#000000000C0000#
#0C0C0C0C0C0C00#
#0C0C0C0C0C0C00#
#00000000000000#
#00000000F00B00#
#0000000C000B00#
#00000000000000#
#0000000C000000#
#00000000000000#
#00000000000000#
################

################
#00000000000000#
#0000CCCCC00000#
#00000000C00000#
#00000000C00000#
#0000CCCCC00000#
#0000C000B00000#
#0000C000B00000#
#0000CCCCC00000#
#00000000000000#
#00000000000000#
#00000000000000#
#0000000F000000#
#00000000000000#
################

################
#00000000000000#
#00000000000000#
#00000000000000#
#00000000C00000#
#00000000000000#
#00000000000000#
#00000000000000#
#00000000000000#
#00000000000000#
#00000000000000#
#00000000000000#
#0000000F0CB000#
#00000000000000#
################

################
#00000000000000#
#00000000000000#
#00000000000000#
#00000000000000#
#00000000000000#
#00000000000000#
#00000000000000#
#0BB00000000000#
#00000000000000#
#00000000000000#
#00000000000000#
#0FCC0000000000#
#00000000000000#
################
